1111111111111111111111111111111111
1E00F0000000000C0000FC0001000000F1
1010010100100000101001000100010101
1010010010101010001001000100010101
1010010010101010001001000100010101
1010010010101010001001000100010101
1010010010101010001001000100010101
1010010011101110001001000100010101
1P0000001C00C0100000000000010000C1
1111111111111111111111111111111111