11111111111111111111111111
1E000000000010000000000001
11000000000P10000000000001
1C000000000010000000000001
10000000000010A00000000001
10000000000010000000000001
10000000000010000000000001
11111111111111111111111111
