1111111111111111111
10C0000000000001A01
1000000000000001001
1000000000000111111
1000P000000000C0E01
1111111111111111111